11111111111111111111111111111111
1001C000000000000000000000000011
100100000100000010001C0000000101
10010000001000001010001000001001
10010000000100001000000100010001
10010000000010000000000000100001
100000000000010000000C0001000001
1000000C00000010000K000010000001
10000000000000010000000100000001
10010000000000000000000000000001
10010000000000000100010000000001
1001000C000000000010100000000001
1001000K0000K0000001000000C00001
100000K1K00000000000100000000001
1000000K000000000E10011000000001
10010000C00000001000000100100101
100100000000001000000000110001P1
11111111111111111111111111111111