111111111111111
1P0000000000001
1C0000C00000001
1C1111111111001
1C0000000000001
1C00000E0000001
1C0000000000001
1C0000000000001
1C0000000000001
111111111111111
111111111111111